money_given=0
max_turns=15
panelty=0
fire_price=-1
cannon_price=-1
0000,0000,0000,0000,0000,0000,0010,,,,,,,END
0000,0000,0000,0000,0000,0000,1010,,,,,,,
0000,0000,0000,0000,0000,0000,1010,,,,,,,
0011,0101,0101,0101,0101,0101,1100,,,,,,,
1010,0000,0000,0000,0000,0000,0000,,,,,,,
1010,0000,0000,0000,0000,0000,0000,,,,,,,
1000,0000,0000,0000,0000,0000,0000,START,,,,,,